1111111111111111111111111111
1000000000000000000000000001
1001111111110111111111111001
1111000111111111111100001001
100100000000CCC0000000001001
1001111110000111111100001001
10P100000000000000000000E001
1001111110000111111100001001
1001000000000000000000011001
1101000000000000000000C10001
1001111111110111111111111001
1000000000000000000000000001
1111111111111111111111111111
